11111111111111111111111111
1C00X0000000111CAAAAAAAAA1
1011110111101111A1111111A1
1011110111101111AAAA1111A1
1011110111101111111A111101
10000000000000000000111101
10111101011011111111111101
10000000000011111110000001
11111101111011011110111111
11111101000000000010111111
11111101011100111010111111
1000000001000C0010000000E1
11111101011111111010111111
11111101000000000010111111
11111101011111111010111111
10000000000011000000000001
10111101111011011110111101
1000110000000P000000110001
11101101011111111010110111
10000001000011000010000001
1A1111111110111111111111A1
1U00000000000A0000000000C1
11111111111111111111111111