1111111111111
10
1000011101001
10PX
1111111111111