1111111111111
10000000000C1
1000011101001
10PX00E000001
1111111111111