111111111111111
1000000000000P1
100C00000000001
100000000000001
100000C00000001
100000000000001
100000000000001
100000000000001
1E0000000000001
111111111111111